C 25,25,112

SO ./textures/0_0.xpm
NO ./textures/1_1.xpm
EA ./textures/2_2.xpm 
WE ./textures/3_3.xpm

F 0,0,0

           11111111111111111111111111
           10000000000000111111 11111
   111111111111000000000001
111111100000000000000000001
111111111011000001110100111111111
100000000011000001111111111111111
11110111111111011100000010001
11110111111011011101010010001
1100000011N101011100000010001     
10000000000000001100001000111
10000000000000001101010010001
1100000111010101111101111000111
11110111 1110101 101111010001
11111111 1111111 11111111111111